
# # # # # # # # # # # 
#                   # 
#   # # #   # # # # # 
#   # E #           # 
#   #   # # # # #   # 
#   #   #           # 
#   #   #   # # #   # 
#   #   #       #   # 
#   #   # # #   #   # 
#           # S #   # 
# # # # # # # # # # # 